Welcome to the magical OOP1 Maze!!!
Card Flip Counter:   0
╬═══════════════════════════════════╬═══════════════════════════════════╬
║UUUUUUUUUUUUUUUUUUUUUUUUUUUUUUUUUUU║UUUUUUUUUUUUUUUUUUUUUUUUUUUUUUUUUUU║
║UUUUUUUUUUUUUUUUUUUUUUUUUUUUUUUUUUU║UUUUUUUUUUUUUUUUUUUUUUUUUUUUUUUUUUU║
║UUUUUUUUUUUUUUUUUUUUUUUUUUUUUUUUUUU║UUUUUUUUUUUUUUUUUUUUUUUUUUUUUUUUUUU║
║UUUUUUUUUUUUUUUUUUUUUUUUUUUUUUUUUUU║UUUUUUUUUUUUUUUUUUUUUUUUUUUUUUUUUUU║
║UUUUUUUUUUUUUUUUUUUUUUUUUUUUUUUUUUU║UUUUUUUUUUUUUUUUUUUUUUUUUUUUUUUUUUU║
║UUUUUUUUUUUUUUUUUUUUUUUUUUUUUUUUUUU║UUUUUUUUUUUUUUUUUUUUUUUUUUUUUUUUUUU║
║UUUUUUUUUUUUUUUUUUUUUUUUUUUUUUUUUUU║UUUUUUUUUUUUUUUUUUUUUUUUUUUUUUUUUUU║
║UUUUUUUUUUUUUUUUUUUUUUUUUUUUUUUUUUU║UUUUUUUUUUUUUUUUUUUUUUUUUUUUUUUUUUU║
║UUUUUUUUUUUUUUUUUUUUUUUUUUUUUUUUUUU║UUUUUUUUUUUUUUUUUUUUUUUUUUUUUUUUUUU║
║UUUUUUUUUUUUUUUUUUUUUUUUUUUUUUUUUUU║UUUUUUUUUUUUUUUUUUUUUUUUUUUUUUUUUUU║
║UUUUUUUUUUUUUUUUUUUUUUUUUUUUUUUUUUU║UUUUUUUUUUUUUUUUUUUUUUUUUUUUUUUUUUU║
║UUUUUUUUUUUUUUUUUUUUUUUUUUUUUUUUUUU║UUUUUUUUUUUUUUUUUUUUUUUUUUUUUUUUUUU║
║UUUUUUUUUUUUUUUUUUUUUUUUUUUUUUUUUUU║UUUUUUUUUUUUUUUUUUUUUUUUUUUUUUUUUUU║
║UUUUUUUUUUUUUUUUUUUUUUUUUUUUUUUUUUU║UUUUUUUUUUUUUUUUUUUUUUUUUUUUUUUUUUU║
║UUUUUUUUUUUUUUUUUUUUUUUUUUUUUUUUUUU║UUUUUUUUUUUUUUUUUUUUUUUUUUUUUUUUUUU║
╬═══════════════════════════════════╬═══════════════════════════════════╬
║UUUUUUUUUUUUUUUUUUUUUUUUUUUUUUUUUUU║██████████████       ██████████████║
║UUUUUUUUUUUUUUUUUUUUUUUUUUUUUUUUUUU║███S██████████       ██████████████║
║UUUUUUUUUUUUUUUUUUUUUUUUUUUUUUUUUUU║██████████████       ██████████████║
║UUUUUUUUUUUUUUUUUUUUUUUUUUUUUUUUUUU║███████                     ███████║
║UUUUUUUUUUUUUUUUUUUUUUUUUUUUUUUUUUU║███████   F             T   ███████║
║UUUUUUUUUUUUUUUUUUUUUUUUUUUUUUUUUUU║███████                     ███████║
║UUUUUUUUUUUUUUUUUUUUUUUUUUUUUUUUUUU║                                   ║
║UUUUUUUUUUUUUUUUUUUUUUUUUUUUUUUUUUU║                                   ║
║UUUUUUUUUUUUUUUUUUUUUUUUUUUUUUUUUUU║                                   ║
║UUUUUUUUUUUUUUUUUUUUUUUUUUUUUUUUUUU║███████                     ███████║
║UUUUUUUUUUUUUUUUUUUUUUUUUUUUUUUUUUU║███████   S                 ███████║
║UUUUUUUUUUUUUUUUUUUUUUUUUUUUUUUUUUU║███████                     ███████║
║UUUUUUUUUUUUUUUUUUUUUUUUUUUUUUUUUUU║██████████████       ██████████████║
║UUUUUUUUUUUUUUUUUUUUUUUUUUUUUUUUUUU║██████████████       ██████████████║
║UUUUUUUUUUUUUUUUUUUUUUUUUUUUUUUUUUU║██████████████       ██████████████║
╬═══════════════════════════════════╬═══════════════════════════════════╬
Possible move: left
 >  > Card Flip Counter:   0
╬═══════════════════════════════════╬═══════════════════════════════════╬
║UUUUUUUUUUUUUUUUUUUUUUUUUUUUUUUUUUU║UUUUUUUUUUUUUUUUUUUUUUUUUUUUUUUUUUU║
║UUUUUUUUUUUUUUUUUUUUUUUUUUUUUUUUUUU║UUUUUUUUUUUUUUUUUUUUUUUUUUUUUUUUUUU║
║UUUUUUUUUUUUUUUUUUUUUUUUUUUUUUUUUUU║UUUUUUUUUUUUUUUUUUUUUUUUUUUUUUUUUUU║
║UUUUUUUUUUUUUUUUUUUUUUUUUUUUUUUUUUU║UUUUUUUUUUUUUUUUUUUUUUUUUUUUUUUUUUU║
║UUUUUUUUUUUUUUUUUUUUUUUUUUUUUUUUUUU║UUUUUUUUUUUUUUUUUUUUUUUUUUUUUUUUUUU║
║UUUUUUUUUUUUUUUUUUUUUUUUUUUUUUUUUUU║UUUUUUUUUUUUUUUUUUUUUUUUUUUUUUUUUUU║
║UUUUUUUUUUUUUUUUUUUUUUUUUUUUUUUUUUU║UUUUUUUUUUUUUUUUUUUUUUUUUUUUUUUUUUU║
║UUUUUUUUUUUUUUUUUUUUUUUUUUUUUUUUUUU║UUUUUUUUUUUUUUUUUUUUUUUUUUUUUUUUUUU║
║UUUUUUUUUUUUUUUUUUUUUUUUUUUUUUUUUUU║UUUUUUUUUUUUUUUUUUUUUUUUUUUUUUUUUUU║
║UUUUUUUUUUUUUUUUUUUUUUUUUUUUUUUUUUU║UUUUUUUUUUUUUUUUUUUUUUUUUUUUUUUUUUU║
║UUUUUUUUUUUUUUUUUUUUUUUUUUUUUUUUUUU║UUUUUUUUUUUUUUUUUUUUUUUUUUUUUUUUUUU║
║UUUUUUUUUUUUUUUUUUUUUUUUUUUUUUUUUUU║UUUUUUUUUUUUUUUUUUUUUUUUUUUUUUUUUUU║
║UUUUUUUUUUUUUUUUUUUUUUUUUUUUUUUUUUU║UUUUUUUUUUUUUUUUUUUUUUUUUUUUUUUUUUU║
║UUUUUUUUUUUUUUUUUUUUUUUUUUUUUUUUUUU║UUUUUUUUUUUUUUUUUUUUUUUUUUUUUUUUUUU║
║UUUUUUUUUUUUUUUUUUUUUUUUUUUUUUUUUUU║UUUUUUUUUUUUUUUUUUUUUUUUUUUUUUUUUUU║
╬═══════════════════════════════════╬═══════════════════════════════════╬
║UUUUUUUUUUUUUUUUUUUUUUUUUUUUUUUUUUU║██████████████       ██████████████║
║UUUUUUUUUUUUUUUUUUUUUUUUUUUUUUUUUUU║███S██████████       ██████████████║
║UUUUUUUUUUUUUUUUUUUUUUUUUUUUUUUUUUU║██████████████       ██████████████║
║UUUUUUUUUUUUUUUUUUUUUUUUUUUUUUUUUUU║███████                     ███████║
║UUUUUUUUUUUUUUUUUUUUUUUUUUUUUUUUUUU║███████   F             T   ███████║
║UUUUUUUUUUUUUUUUUUUUUUUUUUUUUUUUUUU║███████                     ███████║
║UUUUUUUUUUUUUUUUUUUUUUUUUUUUUUUUUUU║                                   ║
║UUUUUUUUUUUUUUUUUUUUUUUUUUUUUUUUUUU║                                   ║
║UUUUUUUUUUUUUUUUUUUUUUUUUUUUUUUUUUU║                                   ║
║UUUUUUUUUUUUUUUUUUUUUUUUUUUUUUUUUUU║███████                     ███████║
║UUUUUUUUUUUUUUUUUUUUUUUUUUUUUUUUUUU║███████   S                 ███████║
║UUUUUUUUUUUUUUUUUUUUUUUUUUUUUUUUUUU║███████                     ███████║
║UUUUUUUUUUUUUUUUUUUUUUUUUUUUUUUUUUU║██████████████       ██████████████║
║UUUUUUUUUUUUUUUUUUUUUUUUUUUUUUUUUUU║██████████████       ██████████████║
║UUUUUUUUUUUUUUUUUUUUUUUUUUUUUUUUUUU║██████████████       ██████████████║
╬═══════════════════════════════════╬═══════════════════════════════════╬
Possible move: left
 > 